We	PRP
re	VBP
determined	VBN
to	IN
future	NN
proof	NN
the	DT
sector	NN
this	DT
summer	NN
,	,
and	CC
meeting	NN
with	IN
our	PRP$
American	JJ
partners	NNS
is	VBZ
crucial	JJ
to	IN
realising	VBG
that	DT
objective	NN
,	,
‚Äù	''
Bartlett	NNP
stated	VBD
.	.
