The	DT
crash	NN
happened	VBD
in	IN
the	DT
early	JJ
hours	NNS
of	IN
May	NNP
1	CD
,	,
when	WRB
the	DT
Cessna	NNP
single	JJ
engine	NN
propeller	NN
plane	NN
with	IN
six	CD
passengers	NNS
and	CC
a	DT
pilot	NN
declared	VBD
an	DT
emergency	NN
due	IN
to	IN
an	DT
engine	NN
failure	NN
.	.
