The	DT
children	NNS
were	VBD
alone	RB
when	WRB
searchers	NNS
found	VBD
them	PRP
and	CC
are	VBP
now	RB
receiving	VBG
medical	JJ
attention	NN
,	,
President	NNP
Gustavo	NNP
Petro	NNP
told	VBD
reporters	NNS
upon	IN
his	PRP$
return	NN
to	IN
Bogota	NNP
from	IN
Cuba	NNP
,	,
where	WRB
he	PRP
signed	VBD
a	DT
cease	NN
fire	NN
agreement	NN
with	IN
representatives	NNS
of	IN
the	DT
National	NNP
Liberation	NNP
Army	NNP
rebel	NN
group	NN
.	.
