BOGOTA	NNP
,	,
Colombia	NNP
(	-LRB-
AP	NN
)	-RRB-
â€”	HYPH
Four	CD
Indigenous	JJ
children	NNS
who	WP
disappeared	VBD
40	CD
days	NNS
ago	RB
after	IN
surviving	VBG
a	DT
small	JJ
plane	NN
crash	NN
in	IN
the	DT
Amazon	NNP
jungle	NN
were	VBD
found	VBN
alive	JJ
Friday	NNP
,	,
Colombian	JJ
authorities	NNS
announced	VBD
,	,
ending	VBG
an	DT
intense	JJ
search	NN
that	WDT
gripped	VBD
the	DT
nation	NN
.	.
