The	DT
tourism	NN
minister	NN
pointed	VBD
to	IN
the	DT
recent	JJ
travel	NN
advisory	NN
and	CC
underscored	VBD
that	IN
it	PRP
is	VBZ
essential	JJ
that	IN
American	JJ
visitors	NNS
are	VBP
reminded	VBN
of	IN
the	DT
safe	JJ
,	,
secure	JJ
and	CC
seamless	JJ
experience	NN
that	IN
a	DT
Jamaican	JJ
vacation	NN
offers	NNS
.	.
