The	DT
president	NN
said	VBD
the	DT
youngsters	NNS
are	VBP
an	DT
example	NN
of	IN
survival	NN
and	CC
predicted	VBD
their	PRP$
saga	NN
will	MD
remain	VB
in	IN
history	NN
.	.
‚Äù	''
